[
  {
    "type": "mapgen",
    "method": "json",
    "om_terrain": [ "s_restaurant_coffee" ],
    "object": {
      "fill_ter": "t_floor",
      "rows": [
        "...!!!!...%__%...!!!!...",
        ".##oooo##.%__%.##oooo##^",
        ".#y tt y#.%__%.#  tt  #.",
        ".othhhhto!%__%!othhhhto.",
        ".oth  hto!%__%!oth  hto.",
        ".#y    y#.%__%.#     y#.",
        ".ohth hto!%__%!oth  hto.",
        ".ohth hto!%__%!oth  hto.",
        ".#      #.%__%.#      #.",
        ".# hh   ##:;;:## h    #.",
        ".#htt     c  c  hth   #.",
        ".# hh            h  h #.",
        ".#                 hth#.",
        ".#y                 h #.",
        ".# AAAAA       hh     #.",
        ".#BCCCCCBBB   htth   R#.",
        ".#        B   htth   R#.",
        ".#YY      d    hh    y#.",
        ".########+||||||||+|+|#.",
        "./DDD``^# 222111|  |  #.",
        "./DDD```#      3|  |  #.",
        "./``````+  OOY33|St|tS#.",
        ".///////###############.",
        "........................"
      ],
      "palettes": [ "standard_domestic_landscaping_palette", "commercial", "parametrized_walls_palette" ],
      "terrain": { ".": "t_region_groundcover_urban", " ": "t_floor", "_": "t_pavement" },
      "furniture": {
        "y": [ "f_indoor_plant", "f_indoor_plant_y" ],
        "B": "f_counter",
        "C": "f_counter",
        "d": "f_counter_gate_c",
        "Y": "f_trashcan",
        "6": "f_table",
        "h": "f_chair",
        "t": "f_table",
        "L": "f_locker",
        "A": "f_sink",
        "U": "f_sink",
        "f": { "param": "display_fridge", "fallback": "f_glass_fridge" },
        "F": { "param": "display_fridge", "fallback": "f_glass_fridge" },
        "O": "f_oven",
        "X": "f_rack",
        "9": "f_rack",
        "l": "f_rack",
        "r": "f_rack"
      },
      "toilets": { ";": {  } },
      "items": {
        "x": { "item": "cash_register_random", "chance": 100 },
        "-": { "item": "coffee_counter", "chance": 10 },
        "6": { "item": "coffee_table", "chance": 35 },
        "9": { "item": "coffee_display_2", "chance": 85, "repeat": [ 1, 8 ] },
        ";": { "item": "coffee_bathroom", "chance": 15 },
        "=": { "item": "coffee_bathroom", "chance": 35 },
        ">": { "item": "coffee_table", "chance": 25 },
        "A": { "item": "coffee_bathroom", "chance": 35 },
        "C": { "item": "SUS_office_desk", "chance": 33 },
        "D": { "item": "SUS_trash_trashcan", "chance": 75 },
        "F": { "item": "coffee_fridge", "chance": 80, "repeat": [ 1, 8 ] },
        "G": { "item": "oven", "chance": 35 },
        "L": { "item": "coffee_locker", "chance": 75 },
        "U": { "item": "coffee_dishes", "chance": 75 },
        "X": { "item": "coffee_newsstand", "chance": 90, "repeat": [ 1, 8 ] },
        "f": { "item": "coffee_freezer", "chance": 85, "repeat": [ 1, 8 ] },
        "l": { "item": "coffee_prep", "chance": 50 },
        "r": { "item": "coffee_condiments", "chance": 80, "repeat": [ 1, 8 ] }
      },
      "monster": { "!": { "monster": "mon_zombie", "chance": 10 } },
      "place_monster": [ { "group": "GROUP_ZOMBIE", "x": [ 3, 17 ], "y": [ 13, 18 ], "chance": 80, "repeat": [ 1, 2 ] } ],
      "vehicles": { "c": { "vehicle": "swivel_chair", "chance": 100 } }
    }
  },
  {
    "type": "mapgen",
    "method": "json",
    "om_terrain": [ "s_restaurant_coffee_roof" ],
    "object": {
      "fill_ter": "t_tile_flat_roof",
      "rows": [
        "                        ",
        " --------      -------5 ",
        " -......-      -......- ",
        " -......-      -......- ",
        " -..1...-      -..1...- ",
        " -......-      -......- ",
        " -......-      -......- ",
        " -......-      -......- ",
        " -......-      -......- ",
        " -......--------......- ",
        " -....................- ",
        " -....................- ",
        " -....................- ",
        " -.....3..............- ",
        " -..............4.....- ",
        " -....................- ",
        " -....................- ",
        " -....................- ",
        " -------5.............- ",
        "        -.............- ",
        "        -.............- ",
        "        -.............- ",
        "        --------------- ",
        "                        "
      ],
      "palettes": [ "roof_palette" ],
      "terrain": { ".": "t_tile_flat_roof", "|": "t_glass_railing" },
      "place_items": [
        { "item": "coffee_table", "x": [ 4, 5 ], "y": [ 18, 19 ], "chance": 50, "repeat": [ 1, 3 ] },
        { "item": "coffee_table", "x": 13, "y": [ 18, 19 ], "chance": 50, "repeat": [ 1, 3 ] },
        { "item": "coffee_table", "x": 17, "y": [ 18, 19 ], "chance": 50, "repeat": [ 1, 3 ] },
        { "item": "coffee_table", "x": 15, "y": [ 10, 13 ], "chance": 50, "repeat": [ 1, 3 ] },
        { "item": "coffee_table", "x": 15, "y": 14, "chance": 50, "repeat": [ 1, 3 ] },
        { "item": "coffee_table", "x": 21, "y": [ 11, 15 ], "chance": 50, "repeat": [ 1, 3 ] }
      ],
      "place_nested": [ { "chunks": [ [ "roof_2x2_golf", 10 ], [ "null", 80 ], [ "roof_3x3_wine", 10 ] ], "x": [ 3, 4 ], "y": [ 10, 13 ] } ]
    }
  }
]
