[
  {
    "type": "overmap_terrain",
    "id": [ "strange_garage_0", "strange_garage_1" ],
    "name": "strange garage",
    "sym": "O",
    "//": "TODO: I want gray but idk the name for it",
    "color": "c_white",
    "looks_like": "garage_gas_1",
    "mondensity": 0,
    "see_cost": "high"
  },
  {
    "type": "mapgen",
    "method": "json",
    "om_terrain": [ [ "strange_garage_0", "strange_garage_1" ] ],
    "object": {
      "fill_ter": "t_thconc_floor",
      "rows": [
        "    ________________                           ",
        "    ________________                           ",
        "    ________________                           ",
        "    ________________                           ",
        "    ________________                           ",
        "    ________________                           ",
        "################################################",
        "#                                              #",
        "#                                              #",
        "#                                              #",
        "#                                              #",
        "#                                              #",
        "#                                              #",
        "#                                              #",
        "#                                              #",
        "#                                              #",
        "#                                              #",
        "#                                              #",
        "#                                              #",
        "#                                              #",
        "#                                              #",
        "#                                              #",
        "#                                              #",
        "################################################"
      ],
      "terrain": { ".": "t_concrete", "#": "t_brick_wall", "_": "t_pavement" },
      "place_zones": [ { "type": "ZONE_START_POINT", "faction": "your_followers", "x": [ 10, 14 ], "y": [ 16, 20 ] } ],
      "furniture": {  },
      "items": {  },
      "place_item": [  ]
    }
  },
  {
    "type": "overmap_special",
    "id": "strange_garage",
    "overmaps": [
      { "point": [ 0, 0, 0 ], "overmap": "strange_garage_0_north" },
      { "point": [ 1, 0, 0 ], "overmap": "strange_garage_1_north" }
    ],
    "locations": [ "land" ],
    "connections": [ { "point": [ 0, -1, 0 ], "connection": "local_road", "terrain": "road", "existing": true, "from": [ 0, 0, 0 ] } ],
    "city_distance": [ 3, -1 ],
    "city_sizes": [ 0, 20 ],
    "occurrences": [ 100, 100 ],
    "rotate": false,
    "flags": [ "CLASSIC", "SAFE_AT_WORLDGEN", "GLOBALLY_UNIQUE" ]
  }
]
