[
  {
    "type": "mapgen",
    "method": "json",
    "om_terrain": [ "abandoned_town_house_04" ],
    "object": {
      "fill_ter": "t_floor",
      "rows": [
        ".%%%..%%%%%%%%p-%%..%%%.",
        ".###oo####o####*##ooo##.",
        ".#  ss R|B  |q|   xxxx#.",
        ".#d    R|B t| |       #.",
        ".od     |B  | +   $$$a#.",
        ".o      |8 8| |  H$$$ #.",
        ".#  @@  |Q S|q|  H$$$ #^",
        ".# s@@s |Q ||||  sHHH #.",
        ".#|||||+||+|  |       #.",
        ".#@@ d|    ||+|       o.",
        ".#d   | $$$$$$$$      #.",
        ".o    + $$$$$$$$      o.",
        ".#y @@|R$$$$$$$$  | h #.",
        ".#|||||R$$$$$$$$  |rrr#.",
        ".#@@  +     y     ||||#.",
        ".#@@  ||||+||      YAL#-",
        ".oy   +D|Q S|   h     *-",
        ".#dsd |||  8| hff     #-",
        ".#||| +    8|  ffh   4#.",
        ".#I Y |||   |6 h     F#.",
        ".oIh  +D|  t|6       2#.",
        ".#IIIy|q|BBB|6  1Y53O7#.",
        ".##oo#####o###*###oo###.",
        "............^---........"
      ],
      "palettes": [ "abandoned_town_palette", "parametrized_carpets_palette" ],
      "terrain": { "$": { "param": "carpet_color_type", "fallback": "t_carpet_green" }, "%": "t_shrub" },
      "set": [
        { "point": "terrain", "id": "t_dirt", "x": [ 0, 14 ], "y": 0, "repeat": [ 5, 8 ] },
        { "point": "terrain", "id": "t_tree_young", "x": [ 0, 14 ], "y": 0, "chance": 5 },
        { "point": "terrain", "id": "t_tree_apple", "x": [ 0, 14 ], "y": 0, "chance": 10, "repeat": [ 1, 2 ] }
      ]
    }
  }
]
